       1  1   1  
       1  1   1
       1  1   1
####11g1  1   11111111111111
   #   1  1   1       
   #   1  1   1          
##### ##11111g1111111111111111
  #    #     
##### ########################
   #   #                    #j
####   #                    #
       ##### ####### ########
       #     #           
       #     #       #    
             #       #