#######################################################
#                                                     #
#                                                     #
##       ###        #####                          ####
#                                                     #
#                                                     #
###  ###         #####          ####           #   ####
#                                                     #
#                                                     #
###              ###            ###            #   ####
#                                                     #
#                                                     #
########               ######  #########       #   ####
#                                      #              #
#            ####      ######  #########              #
#                                                     #
#                                                     #
#######################################################