       #      #               
       #  #   #
       #  #   #
###### #  #   # ##############
   #   #  #   #       
   #      #             
##### ########################
  #    #     
##### ##111111g111111111111111
   #   1                    1
####   1                    1
       11111g1111111g11111111
       1     1       g    
       1     1       1    
       g     1       1