00123456789+123456789=123456789
0           #        #       
1           #        *        
2           #        #       
3           _        #       
4           #        #       
5           #        #       
6#####*###################_####
7                #           
8                #           
9                #           
+                -           
1                #           
2                #           
3                #           
4                #           

