  #    #  #   #   #   #       #
  #    #  #   #   #   #=###=###
  ####=#  #   #   #   #   #%  #
    %  #  ###=#=###   #¡ý  #   #         
####   #      #       #####   #
       #         #            #
    ##### ########^#######=####   
  % #   #   %    #     #      #
## ##   ###   #  #     #  #   #
    # !   #   #  #####=#  #=###  
   ##     #   #    #  *#  #   #
    #  #  #  *#  ½£ #   ###   #
##  #  ##=###=#   %#      #   #
    #  #      ######  #=###   #
       #     %        #       #
###############################