  #    #  #   #   #   #       #
  #&   #  #$  #   #   #   ##=##
  ####=#  #   #   #   #  %#   #
       ##=#=###   #   #  ^#   #      
####   #      #=###   ###=#   #
       #      #  =     %      #
    ## ##    #####^#######=####   
    #   #        #     #      #
## ##   ###   #  #     #  #   #
          #   #  #####=# %#=###  
         %#   #    #   #  #   #
    ## #  #   # %  #   ##=#   #
#####  ##=###=#    # %    #   #
    8  #      ######      #   #
@      #    %              #   #
###############################